NO ./textures/purplestone.xpm       F    255,128,111 




SO ./textures/mossy.xpm        WE               ./textures/redbrick.xpm 



         EA    ./textures/wood.xpm              C 42,82,190         




1111
1001
1111
     11111111111
1111100100000001
1000001 10001111
100000111001
100000000001
11111000N00011111
    1000000000001
    1000000000111
 11111111111111






