NO ./textures/purplestone.xpm       F    255,128,111 




SO ./textures/mossy.xpm        WE               ./textures/redbrick.xpm 



         EA    ./textures/wood.xpm              C 42,82,190        



11111111111111111111111111111111111111111111111111111111111111111111111111111111111111111111111111111111111111111111
10000011100000111000001110000011100000111000001110000011100000111000001110000011100000111000001110000011100000110001
11111000001110000011100000111000001110000011100000111000001110000011100000111000001110000011100000111000001110000N01
11111111111111111111111111111111111111111111111111111111111111111111111111111111111111111111111111111111111111110001
11111111111111111111111111111111111111111111111111111111111111111111111111111111111111111111111111111111111111111111