NO ./textures/purplestone.xpm       F    255,128,111 




SO ./textures/mossy.xpm        WE               ./textures/redbrick.xpm 



         EA    ./textures/wood.xpm              C 42,82,190        




11111111111111111111111111111
10000000000001010000000000001
10000000000001110000000000001
10000000000000000000000000001
10000001110000000001110000001
10000001010000W00001010000001
10000001110000000001110000001
10000000000000000000000000001
10000000000001110000000000001
10000000000001010000000000001
11111111111111111111111111111



