NO ./textures/purplestone.xpm   SO ./textures/mossy.xpm

WE ./textures/redbrick.xpm

EA ./textures/wood.xpm
C 0,0,0

F 50,50,50





11111111111111111111111111111
10000000000001010000000000001
10000000000001110000000000001
10000000000000100000000000001
10000001110000000001110000001
10000001011000W00011010000001
10000001110000000001110000001
10000000000000100000000000001
10000000000001110000000000001
10000000000001010000000000001
11111111111111111111111111111



